ActorEditor=参与者编辑
Actors=参与者
Comments=评论
Configuration=设置
DataProvider=数据提供者
EcoSpold=EcoSpold 1
ElementaryFlows=基础流
EmptyCategories=空类别
FlowEditor=流编辑
FlowProperties=流特性
FlowPropertyEditor=流程特性编辑
Flows=流
GlobalParameters=全局参数
ILCDNetworkExport=从 ILCD 网络导出
ILCDNetworkImport=从 ILCD 网络导入
ImpactMethodEditor=影响评估方法编辑
ImpactMethods=影响评估方法
ImportEntireDatabase=导入整个数据库
ImportEntireDatabase_Info=将一个完整的数据库导入到活动数据库中。
ImportExport=导出/导入
LCIAMethods=LCIA方法
Locations=位置
Logging=记录
Navigation=导航
NumberFormat=数字格式
Perspective=透视
ProcessEditor=过程编辑
Processes=过程
ProductFlows=产品流
ProductSystemEditor=产品系统编辑
ProductSystems=产品系统
ProjectEditor=项目编辑
ReportViewer=报告浏览者
SearchResults=搜索结果
SourceEditor=来源编辑
Sources=来源
UnitGroupEditor=单位组编辑
UnitGroups=单位组
Updates=更新
Usage=用法
WasteFlows=废物流
Welcome=欢迎