#Tue Feb 28 11:52:19 CET 2023
ALocationCodeIsRequired=位置編碼為必填
AccessAndUseRestrictions=存取和限制
ActivityQuantity=活動數據品質
ActivityUnit=活動單位
ActivityVariable=活動變數
Actor=參與者
Actors=參與者們
Add=增加
AddIndicator=加入新指標
AddInputFlow=增加輸入流程
AddNewChildCategory=增加新的子類別
AddOutputFlow=增加輸出流程
AddProcess=增加工序
AddScore=加入新評分
AddSection=增加區塊
AddToMethodParameters=增加方法的參數
AddedValue=增加數值
AdditionalInformation=附加資訊
Address=地址
AdministrativeInformation=管理資訊
Aggregation=合計
AggregationType=合計類型
Allocation=分配
AllocationFactors=分配要素
AllocationMethod=分配方法
AlreadyConnected=已連線
AlreadyPresent=已存在
Amount=數量
AnErrorOccuredWhileReceivingCommitData=接收提交資料時發生錯誤
Analysis=分析
AnalysisResultOf=分析結果
AnalyzingForProblems=分析問題
AsDefinedInProcesses=如工序中定義
AssessDataQuality=評估資料品質
AssignUnits=指定單位
AvoidedProduct=避免產品
AvoidedProductFlow=避免生產流程
AvoidedWasteFlow=避免廢物流程
BackgroundData=背景資料
BaseUncertainty=不確定性
Browse=瀏覽
BuildNextTier=建立下一層
BuildSupplyChain=建立供應鏈
Bulkreplace=大量取代
BulkreplaceFlows=大量取代流程
BulkreplaceProviders=大量取代供應者
CASNumber=CAS編號
CSVFormat=CSV 格式
Calculate=計算
CalculateCosts=計算成本
CalculateDefaultValues=計算預設值
CalculateResults=計算結果
CalculateStatistics=計算統計
CalculationProperties=計算特性
CalculationType=計算類型
CalculationWizardDescription=請選擇要計算的特性
CanNotSaveParameter=無法儲存參數，可能公式內容錯誤
Cancel=取消
CannotDelete=無法刪除
CannotDeleteFlowProperty=無法刪除流程屬性
CannotDeleteMessage=所選擇的元件無法刪除，它已經被使用於其他資料組合，請查詢它在哪裡已被使用。
CannotDeleteRefFlow=無法刪除參考流程
CannotDeleteRefFlowMessage=無法刪除工序中參考的流程
CannotDeleteReferenceFlowProperty=不能删除參考的流程特性
CannotDeleteReferenceUnit=無法刪除參考的單位
CannotDeleteUnit=無法刪除單位
CannotRemoveExchanges=無法移除交換資料
Category=類別
CategoryNotEmpty=類別不是空的
Causal=原因
CausalAllocation=原因的分配
Change=改變
CheckingOutCommit=檢出已提交
Checkout=檢出...
ChooseDirectory=選擇目錄...
City=城市
ClearData=清除資料
ClickHereToChangeDisplay=點擊這裡變更顯示
Close=關閉
CloseDatabase=關閉資料庫
Code=郵遞區號
Collapse=摺疊
CollapseAll=摺疊全部
ColumnSeparator=分割欄位
Comma=逗號
Comment=評論
Commit=提交…
CommitChangesToRepository=提交變更至儲存庫
CommitDate=提交日期
CommitMessage=提交訊息
CommitReferenceNotice=需要先提交後才能參考所有變更
CommitingChanges=提交變更
Committer=提交者
Compare=比對
ComparingWithRepository=比對儲存庫
Complete=完成
CompleteReferenceData=完成參考的資料
Component=元件
Configuration=配置
ConfigureEcospoldMessage=此頁你能配置匯出EcoSpold格式
Connect=連線
ConnectProviders=連線提供者
ConnectRecipients=連線接收者
ConnectingToRepository=連線到儲存庫
Connection=連線
ConnectionFailed=連線失敗
ConsumedBy=消耗
Content=內容
Context=背景
Contribution=貢獻
ContributionTree=貢獻樹狀圖
ContributionTreeLocations=貢獻樹狀圖位置
ConversionFactor=轉換因素
Copy=複製
CopyAllFromRightToLeft=從右邊複製至左邊
CopySelectionFromRightToLeft=複製右邊已選擇至左邊
Copyright=版權所有
CostCategory=成本類別
CostFormula=成本計算公式
CostResult=成本結果
CostValue=成本價值
Costs=成本
CostsPerUnit=單位成本
CostsRevenues=成本/收入
CouldNotAllocateMemoryError=openLCA不能定址到更多的實體記憶體去進行計算。請調整你的記憶體設定( 檔案/偏好 -> 設定)
CouldNotFindKMLData=你提供的檔案無法找到KML資料，您確定它是EcoSpold2格式嗎？更詳細資訊可以前往http\://www.ecoinvent.org/data-providers/how-to-submit-data/ecospold2了解。
CouldNotOpenDatabase=無法打開資料庫
CouldNotOverwriteFile=無法覆寫檔案
Country=國家
Coverage=範圍
CreateANewDatabase=建立新資料庫
CreateANewProductFlowForTheProcess=建立工序的生產流程
CreateDatabase=建立資料庫
CreateDefaultValuesForMissingFields=替缺少資料建立預設值
CreateNew=建立新的
CreateProcess=建立工序
CreateProcesslink=建立工序連結
CreateProductSystem=建立產品系統
CreatesANewActor=建立新的參與者
CreatesANewDataQualitySystem=建立新的資料品質系統
CreatesANewFlow=建立新的流程
CreatesANewFlowProperty=建立新的流程特性
CreatesANewImpactMethod=建立新的影響評估方法
CreatesANewLocation=建立新的位置
CreatesANewParameter=建立新的參數
CreatesANewProductSystem=建立新的生產系統
CreatesANewProject=建立新的方案
CreatesANewSource=建立新的來源
CreatesANewUnitGroup=建立新的單位群組
CreatingEcoSpoldFolder=建立ecoSpold目錄
CreatingProductSystem=正建立生產系統
CreationDate=建立日期
Currencies=貨幣
Currency=貨幣
CurrencyCode=貨幣代碼
Cut=剪下
Cutoff=剪下
DBImportNoTarget=匯入時需要打開目標資料庫
DBImportNoTargetConnectionFailedMessage=無法取得來源資料庫版本
DBImportUpdateDatabaseQuestion=匯入資料庫時必需要更新來源資料庫，你確定嗎？
DBImportVersionNewerMessage=來源資料庫版本比openLCA還新
DataCollectionPeriod=資料收集頻率
DataCompleteness=資料完成度
DataDocumentor=資料文件人員
DataGenerator=資料產生人員
DataQuality=資料品質
DataQualityEntry=資料品質
DataQualityProperties=資料品質特性
DataQualitySystem=資料品質系統
DataQualitySystems=資料品質系統
DataSelection=資料挑選
DataSet=資料組合
DataSetOtherEvaluation=資料組其他評估
DataSetOwner=資料組合擁有者
DataSets=資料組合
DataSourceInformation=資料來源資訊
DataTreatment=資料整理
Database=資料庫
DatabaseContent=資料庫內容
DatabaseImport=資料庫匯入
DatabaseImportDescription=匯入現有資料庫內容至已開啟的資料庫
DatabaseName=資料庫名稱
DatabaseNewerThanThisError=你給的資料庫比openLCA的版本還新
DatabaseRenameError=你給的名稱是無效的或是資料庫名稱已存在
DatabaseType=資料庫類型
DatabaseValidationCompleteNoErrorsWereFound=資料庫完成驗證，沒有發現錯誤
DatabaseVersionCheckFailed=無法取得資料庫版本，這是openLCA使用的資料庫？
DatabaseWasExportedToFile=資料庫已經匯至檔案
DecimalSeparator=數字區隔
DefaultFlowProperty=預設流程屬性
DefaultMethod=預設方法
DefaultProvider=提供者
Delete=刪除
DeleteCategoryQuestion=你確定要刪除已選擇的類別？
DeleteDatabase=刪除資料庫
DeleteFile=刪除檔案
DeleteProcess=刪除工序
DeleteProcesslink=刪除工序連結
DeleteReportSectionQuestion=你確定要刪除報告區塊？
DeleteSection=刪除區塊
DeleteShapeFile=刪除shape檔案
DependenantParameter=依賴參數
DependentParameter=依賴參數
DependentParameters=依賴的参数
Description=內容
DeveloperTools=開發者工具
Direct=直接
DirectContribution=直接貢獻
DirectContributionsFlowResultsOverview=直接貢獻流程-概觀
DirectContributionsImpactCategoryResultsOverview=直接貢獻影響類別的結果-概觀
Direction=方向
DisconnectFromRepository=儲存庫離線
Display=顯示
DoNotShowThisMessageAgain=不再顯示此訊息
DoYouReallyWantToDelete=你確定要刪除？
Dot=點
DownloadingData=下載資料...
EcoSpold2Export=匯出至EcoSpold 2
EcoSpoldConfiguration=EcoSpold設定
Economic=經濟
Edit=編輯
EditFlow=編輯輸入
ElementaryFlow=元素流程
Email=電子信箱
EmptyDatabase=空的資料庫
EmptyValueMessage=輸入值是空的
EnableJblasLibrary=開啟jblas函數庫
EndDate=結束日期
EnterLocationNameAndCode=請在新的位置輸入名稱及郵遞區號
Error=錯誤
ErrorPopupMessage=開啟log檔了解更多資訊
ErrorPopupTitle=發生例外的錯誤
Errors=錯誤
EvaluateLocations=評定位置
EvaluatingLocations=評定位置
EvaluationSchema=評定格式
Example=例子
ExcelExport=匯出至Excel檔
ExchangeDataQualitySchema=交換資料品質格式
ExchangesAreUsed=選擇的交換資料已經被使用在生產系統中無法被刪除
ExcludeExchangesWithDefaultProviders=排除預設交換提供者
ExcludeZeroEntries=排除空項目
ExcludeZeroValues=排除零值
Expand=展開
ExpandAll=展開全部
Export=匯出...
ExportAsMatrix=匯出matrix
ExportDataSets=匯出資料組合
ExportDataSetsInOneFile=匯出所有的資料組合至單一檔嬣
ExportDatabase=匯出資料庫
ExportDirectory=匯出至目錄
ExportDone=匯出完成
ExportEcoSpold=匯出EcoSpold
ExportILCD=匯出ILCD
ExportMatrix=匯出矩陣
ExportProcess=匯出工序
ExportReport=匯出報告
ExportResults=匯出結果
ExportResultsToExcel=匯出結果至Excel
ExportToExcel=匯出至Excel
ExportingProcesses=匯出處理中
ExternalFile=外部檔案
ExternalSource=外部來源
ExternalSourceChange=改變外部來源
Factor=因數
Factors=因數
FailedToLoadFlowProperty=無法載入流程屬性
Fetch=提取...
FetchingChanges=提取所有變更
FetchingCommits=提取所有提交
FetchingData=提取資料
File=檔案(&F)
FileAlreadyExists=檔案已經存在
FileDoesNotExist=檔案不存在
FileImportPage_Description=請選擇要匯入的檔案
Files=檔案
Filter=篩選
FilterByName=名稱篩選
Flow=流程
FlowContributions=流程貢獻
FlowContributionsToProcessResults=流程貢獻至工序結果
FlowDataQualitySchema=資料品質流程圖解
FlowDataQualityStatistics=資料品質流程統計
FlowProperties=流程特性
FlowProperty=流程特性
FlowPropertyIsUsed=此流程特性已經存在工序或影響評估方法
FlowPropertyType=流程特性類型
FlowSchema=流程圖解
FlowType=流程類型
Flows=流程
Folder=目錄
Formula=公式
FormulaEvaluationFailed=公式估算失敗
FormulaInterpreter=公式解譯
FoundProblems=找到問題\:
FromDirectory=從目錄\:
GeneralInformation=基本資訊
Geography=地理資訊
GeographyDescription=地理資訊內容
GeometricMean=幾何平均數
GeometricMeanFormula=幾何平均數(公式)
GeometricStandardDeviation=幾何標準偏差
GeometricStandardDeviationFormula=幾何標準偏差(公式)
Geometry=幾何
Global=全球性的
GlobalParameter=全域性參數
GlobalParameters=全域性參數
GoalAndScope=目的和範圍
Group=群組
Grouping=群組
Groups=群組
HEADRevision=HEAD指標的修訂版本
HTMLGraph=HTML圖表
HalfUp=四捨五入
HasUncertainties=有不確定因素
Help=幫助(&H)
Hide=隱藏
HighOpportunity=高機率
HighRisk=高風險
Home=首頁
Host=主機
ILCDNetworkExport=ILCD網路匯出
ILCDNetworkExportDescription=匯出工序或生產系統到ILCD網路
ILCDNetworkSettings=ILCD網路設定
ILCDOtherSettings=ILCD其他設定
ILCD_AUTHENTICATION_FAILED_MSG=驗證失敗，請檢查名稱和密碼是否正確
ILCD_CONNECTION_FAILED_MSG=連接失敗，請檢查網路連線、網址、使用者資料是否正確
ILCD_CONNECTION_WORKS_MSG=連接正常
ILCD_NO_READ_OR_WRITE_ACCESS_MSG=沒有讀或寫的權限
ILCD_NetworkImport=網路匯入
ILCD_RunImport=開始匯入
ILCD_SearchFailedMessage=網路搜尋失敗
ILCD_SearchPageDescription=搜尋或選擇匯入
Id=ld
ImageExport=匯出圖形
ImpactAnalysis=影響評估分析
ImpactAssessmentMethod=影響評估方法
ImpactAssessmentMethods=影響評估方法
ImpactAssessmentResults=影響評估結果
ImpactCategories=影響評估類別
ImpactCategory=影響評估類別
ImpactFactor=影響因數
ImpactFactors=影響因數
ImpactResult=影響結果
Import=匯入...
ImportData=匯入資料
ImportDatabase=匯入資料庫
ImportEcoSpold=匯入 EcoSpold
ImportEcoSpold01DataSets=匯入 EcoSpold01 資料組合
ImportEcoSpold02DataSets=匯入 EcoSpold02 資料組合
ImportEcoSpoldGeographies=匯入 EcoSpold2 座標
ImportILCD=匯入 ILCD
ImportKMLGeographies=匯入 KML 座標
ImportingKMLData=匯入 KML 資料
ImportingXMLData=匯入 XML (EcoSpold2格式）資料
IncludeCostCalculation=引入費用計算
Indicator=指標
IndicatorBarChart=指標長條圖
Indicators=指標
IndicatorsAndParameters=指标及参数
IndicatorsScores=指標與分數
Information=資訊
InfrastructureFlow=基礎流程
InfrastructureProcess=基礎工序
Initializing=初始化
Input=輸入
InputOutput=輸入/輸出
InputParameter=輸入參數
InputParameters=輸入參數
Inputs=输入
InputsOutputs=输入/输出
IntendedApplication=預期的應用
InterventionMatrix=干預矩陣
InvalidAllocationFactor=無效的因數
InvalidAllocationFactorMessage=分配因數的值介於0到1
InvalidFormula=無效的公式
InvalidMemoryValue=無效的記憶體值
InvalidNumber=無效的編號
InvalidParameterName=無效的參數名稱
InvalidValue=無效的值
Inventory=盤查
InventoryResult=盤查結果
InventoryResults=盤查結果
IsDefault=為預設
IsInvalidFormula=是無效的公式
IsNotValidNumber=是無效的編號
IsNotValidParameterName=是無效的參數名稱
IsReference=是參考資訊
KmlEditor=KML 編輯
LCCAddedValuesTable=LCC\:表格值已加入
LCCNetcostsTable=LCC\:淨成本表格
LCIAMethod=LCIA 方法
LCIMethod=LCIA 方法
Label=標籤
Language=語言
LastChange=上次修改
Latitude=緯度
Layout=版面配置
LayoutAs=版面配置為{0}
LciaCategoryDescriptionTable=LCIA 類別說明表格
LciaResultTable=LCIA 結果表格
LibgfortanInfo=openLCA使用jblas函數庫驗證計算效能，使用Linux必需要安裝libgfortran3套件，如果你使用Ubuntu可以利用命令安裝套件'apt-get install libgfortran3'
Line=行
Local=本地
LocalDatabase=本地資料庫
Location=位置
Locations=位置
LogFile=紀錄檔
LogNormalDistribution=對數正態分析
Longitude=經度
LowOpportunity=低機率
LowRisk=低風險
ManagePlugins=管理外掛
Map=地圖
Mark=標記
MarkAsMerged=標記為合併
MatrixExport=矩陣匯出
MatrixFiles=矩陣檔案
Maximize=最大化
MaximizeAll=全部最大化
Maximum=最大
MaximumFormula=最大(公式)
MaximumMemoryUsage=記憶體使用量(MB計算)
Mean=平均
MeanFormula=平均(公式)
MediumOpportunity=中度機率
MediumRisk=中度風險
MemoryToHighMessage=記憶體使用量太高
MemoryToLowMessage=記憶體需求至少256MB
Message=訊息
Methods=方法
MinimalTree=最小化樹狀
Minimize=最小化
MinimizeAll=全部最小化
Minimum=最小
MinimumFormula=最小(公式)
Mode=模型
ModeFormula=模型(公式)
ModelGraph=模型圖表
ModelType=模型類型
ModelingAndValidation=建模型和驗證
ModelingConstants=建模型常數
MonteCarloSimulation=蒙地卡羅摸擬
Move=移動
MoveDown=向下移
MoveUp=向上移
MultiLine=多行
MultiPoint=多點
MultiPolygon=多邊型
NaValueHandling=未知的數值處理
Name=名稱
NameCannotBeEmpty=名稱不能空白
NameShouldBeDifferent=名稱必需不一樣
NeedOpenDatabase=開啟資料庫
NetCosts=淨成本
Netcosts=淨成本
NewActor=新的參與者
NewCategory=新的類別
NewCurrency=新的貨幣
NewDataQualitySystem=資料品質系統
NewDatabase=新的資料庫
NewDatabase_AlreadyExists=資料庫名稱已經存在
NewDatabase_InvalidName=名稱內容包含無效的內容(允許\:英文、數字）
NewDatabase_NameToShort=資料庫必名稱長度必需大於4
NewFlow=新的流程
NewFlowProperty=新的流程特性
NewImpactCategory=新的影響評估方法類別
NewImpactMethod=新的影響評估方法
NewLCIAMethod=新的 LCIA 方法
NewLocation=新的位置
NewParameter=新的參數
NewProcess=新的工序
NewProductSystem=新的生產系統
NewProject=新的專案
NewSection=新的區塊
NewSocialIndicator=新的社會指標
NewSource=新的來源
NewUnitGroup=新的單位群組
No=否
NoAccessToRepository=儲存庫不存在或沒有權限
NoAnalysisOptionsSet=沒有分析選項
NoChangesInLocalDb=本地資料庫沒有變更
NoData=沒有資料
NoDatabaseOpened=沒有開啟資料庫
NoDescription=沒有說明
NoDistribution=沒有分佈
NoExportFilesSelected=沒有選擇匯出的檔案
NoParameterSelected=沒有選擇參數
NoProjectVaraintsAreDefined=沒有定義專案變數
NoQuantitativeReferenceSelected=沒有選擇參考數量
NoReferenceFlowPropertySelected=沒有選擇參考流程
NoReferenceProcessSelected=沒有選擇參考工序
NoReferenceSet=沒有設定參照
NoRisk=沒有風險
NoShapefileParameterSelected=沒有選擇shape檔案參數能被加入參數方法
NoUnitGroupSelected=沒有選擇單位群組
None=無
NormalDistribution=一般分佈
NormalisationBarChart=一般長條圖
NormalisationRadarChart=一般雷達圖
NormalisationResultTable=一般結果表格
Normalization=一般
NormalizationAndWeightingSet=一般和加權集
NormalizationFactor=一般因數
NormalizationWeighting=一般和加權
NormalizationWeightingSets=一般和加權組合
NotAnIntegerNumber=輸入的值並非整數
NotApplicable=不適用
Note=筆記
NoteDefaultProviders=註\:已有的提供者無法符合時會被預設提供者取代.勾選上面可以防止提供者被預設提供者取代
Notification=通知
NumberFormatPage_Description=設定顯示數字的小數點位數
NumberOfDecimalPlaces=小數點位數
NumberOfIterations=重覆次數
NumberOfSimulations=模擬次數
OK=確定
OfProduct=為產品
OnlineHelp=線上幫助
Open=開啟
OpenDatabase=開啟資料庫
OpenEditor=開啟編輯
OpenInEditor=編輯器中開啟
OpenLCALog=紀錄檔
OpenLogFile=開啟紀錄檔
OpenMiniatureView=開啟縮圖
OpenPluginManager=開啟外掛管理
Other=其他
OutOfMemory=記憶體不足
Output=輸出
Outputs=輸出
OverwriteFile=覆寫檔案
OverwriteFileQuestion=選擇的檔案已經存在，你確定要覆寫它嗎？
Parameter=參數
ParameterAlreadyAdded=參數已經加入
ParameterDescriptionTable=參數內容表格
ParameterValueTable=參數數值表格
ParameterWithSameNameExists=參數名稱已經存在
ParameterWithSameNameExistsInMethod=參數名稱已經存在LCIA方法
Parameters=參數
Password=密碼
Paste=貼上
PedigreeMatrix=系譜矩陣
PedigreeMatrixMessage=矩陣單元上點擊項目
Physical=物理
PhysicalAndEconomicAllocation=物理和經濟分配
PleaseEnterAName=請輸入名稱
PleaseEnterANewName=請輸入新名稱
PleaseEnterTheNameOfTheNewCategory=請輸入新類別的名稱\:
PleaseSelectThePropertiesForTheDataQualityAssessment=請選擇資料品質評估的特性
PleaseSpecifyHost=請指定主機
PleaseSpecifyPortNumber=請指定通訊埠號碼
PleaseSpecifyUser=請指定用者
Point=點
Polygon=多邊型
Port=通訊埠
Position=位置
Prefer=偏好\: {0}
Preferences=优先
Preparing=準備中
Price=價格
Process=工序
ProcessContributionChart=工序貢獻圖
ProcessContributions=工序工獻
ProcessDataQualitySchema=工序資料品質圖解
ProcessDataQualityStatistics=工序資料品質統計
ProcessDocumentation=工序文件
ProcessEvaluationAndValidation=工序評估與驗證
ProcessExcelImportDescription=從微軟Excel匯入工序
ProcessLinks=工序鏈結
ProcessResults=工序結果
ProcessSchema=工序圖解
ProcessType=工序類型
Processes=工序
ProducedBy=生產者
Product=生產
ProductSystem=生產系統
ProductSystemExcelExport=生產系統Excel匯出
ProductSystemExcelExportMessage=請選擇匯出生產系統的目錄
ProductSystemStatistics=生產系統統計
ProductSystems=生產系統
Progress=工序
Project=方案
ProjectSetup=方案設定
Projects=方案
Properties=特性
Providers=提供者
Publication=發佈
QuantitativeReference=數量的參考
Quantity=數量
QuickResults=快速的結果
RawValue=原始值
ReallyDeleteShapeFile=你確定要刪除選擇的shape檔案？所有的變更會被自動儲存
RecalculateQuestion=所有值將會被重新計算，你確定要執行？
ReconnectProcesslink=重新連線工序連錄
Reference=參考
ReferenceCurrency=貨幣的參考
ReferenceFlowProperty=流程特性的參考
ReferenceFlowPropertyCannotBeDeleted=流程特性的參考不能被刪除
ReferenceProcess=參考的工序
ReferenceUnit=參考的單位
ReferenceUnitCannotBeDeleted=群組中參考的單位不能被刪除
ReferenceUnitIsEmptyOrInvalid=參考的單位為空白或無效的
RegionalizedLCIA=LCIA 地區
RejectMessage=請求拒絕,請提取儲存庫最後的更新
RelativeLciaResultsBarChart=相應的 LCIA 結果 - 長條圖
RelativeLciaResultsRadarChart=相應的 LCIA 結果 - 雷達圖
Reload=重新載入
Remote=遠端
RemoteDatabase=遠端資料庫
Remove=移除
RemoveConnections=移除連線
RemoveIndicator=移除指標
RemoveObject=移除物件
RemoveScore=移除評分
RemoveSelected=移除已選擇的
RemoveSupplyChain=移除供應鏈
Rename=更名
ReplaceFlow=取代流程
ReplaceProvider=取代提供者
Report=報告
ReportName=報告標簽
ReportSections=報告區塊
ReportView=報告瀏覽
Reset=重新設定
ResetAll=全部重新設定
ResetSelection=重新設定區塊
Resize=調整大小
Result=結果
Results=結果
ResultsOf=結果的
ResultsOfProject=專案的結果
Reviewer=檢閱人
RiskLevel=風險層級
RoundingMode=進位模式
Route=路徑
RunCalculation=開始計算
SamplingProcedure=取樣步驟
SankeyDiagram=桑基圖表
Sankey_ScaleDescription=工序顏色(貢獻度百分比%)
Save=存檔
SaveAs=另存為...
SaveAsImage=另存為圖檔
SaveChanges=儲存所有變更
SaveChangesQuestion=你確定儲存所有變更
SavingDiagramAsImageIn=儲存圖表為圖檔在{0}
Scores=分數
Search=搜尋
SearchAllTypes=搜尋所有類型
SearchInActors=搜尋參與者們
SearchInDataQualitySystems=搜尋資料品質係統
SearchInFlowProperties=搜尋流程特性
SearchInFlows=搜尋流程
SearchInLCIAMethods=搜尋LCIA方法
SearchInLocations=搜尋位置
SearchInParameters=搜尋參數
SearchInProcesses=搜尋
SearchInProductSystems=搜尋生產系統
SearchInProjects=搜尋方案
SearchInSocialIndicators=搜尋社會指標
SearchInSources=搜尋分數
SearchInUnitGroups=搜尋單位群組
SearchParameters=搜尋參數
SearchProvidersFor=搜尋提供者
SearchRecipientsFor=搜尋接受者
SearchResults=搜尋結果
Searching=搜尋中...
SearchingForReferencedChanges=搜尋所有已參考的變更
SearchingForUnits=搜尋單位...
Section=區塊
Select=選擇{0}
SelectADirectory=請選擇目錄
SelectAll=全選
SelectImportFiles=選擇匯入的檔案
SelectLanguageNoteMessage=直到重新啟動時變更才會生效
SelectNext=選擇下一個
SelectObjectPage_Description=請指定輸出目錄與選擇 {0}你想要匯出的
SelectPrevious=選擇上一個
SelectProviders=選擇供應者
SelectRecipients=選擇接受者
SelectTheExportFile=選擇匯出檔案
SelectTheParameterYouWantToReferTo=選擇你想要引用的參數
SelectedParameterWasAlreadyAdded=所選擇的參數已經加入 LCIA 方法
Semicolon=分號
ServerConfigurations=伺服器設定
ServerUrl=伺服器位址
SetAsReferenceCurrency=設定成參考的貨幣
SetReferenceCurrencyQuestion=你想要設定貨幣成參考貨幣資料庫中？
SetSankeyDiagramOptions=設定桑基圖表選項
Settings=設定
SettingsOfTheSankeyDiagram=設定桑基圖表
Show=顯示
ShowFormulas=顯示公式
ShowInHistory=顯示歷史
ShowInMap=顯示於地圖
ShowOutline=顯示概要
ShowValues=顯示數值
Showviews=顯示視野(&V)
SimaProCSVImport=匯入SimaPro CSV格式
SingleScore=單一分數
SingleScoreBarChart=單一分數長條圖
SingleScoreTable=單一分數表格
SocialAspect=社會觀點
SocialAspects=社會觀點
SocialAssessment=社會評估
SocialDataQualitySchema=社會品質格式
SocialIndicator=社會指標
SocialIndicators=社會指標
SocialSchema=社會格式
SolvingProblems=解決問題
SomeParametersWereNotAdded=一些參數無法加入，可能加入無效的參數或是相同的名稱
Source=來源
SourceFileDeleteQuestion=您確定刪除此檔案？
SourceFileOverwriteFileQuestion=資料庫中已經有相同名稱，你確定要覆寫嗎？
Sources=來源
StandardDeviation=標準偏差
StandardDeviationFormula=標準偏差(公式)
Start=開始
StartDate=開始日期
Statistics=統計資料
SubCategory=子類別
SubgroupByProcesses=工序子類別
Synonyms=同義
SystemDefinesUncertainties=系統不確定因素定義
SystemProcess=系統程序
SystemSaveProceedQuestion=生產系統必需被儲存，你確定要執行嗎？
Tab=Tab
TargetAmount=目標數量
Technology=技術
TechnologyDescription=技術內容
Telefax=傳真
Telephone=電話
Test=測試
TestDistribution=測試分佈
TexchnologyMatrix=技術矩陣
Text=文字
TextDropComponent_ToolTipText=從導覽拖動選擇的物件到文字欄位或點擊去開啟對話框
TextReference=文字參考
Theme=主题
Time=時間
TimeAndAuthor=時間和作者
TimeDescription=時間內容
Title=標題
ToDirectory=到目錄
ToFile=到檔案
TotalAddedValue=總加入值
TotalNetcosts=總淨成本
TotalRequirements=總需求
Tree=樹狀
TriangleDistribution=三角形分佈
Type=類型
URL=網址
Uncertainties=不確定因素
Uncertainty=不確定性
UncertaintyDistribution=不確定性分佈
UniformDistribution=平均分佈
Unit=單位
UnitAlreadyExistsInUnitGroup=單位已經在群組中{0}
UnitGroup=單位群組
UnitGroups=單位群組
UnitIsUsed=單位已使用在工序、影響評估方法或社會指標
UnitMappingPage_Description=匯入工序時請選擇流程特性，如果它是新的單位需指定轉換系數
UnitOfMeasurement=單位計算
UnitProcess=單位工序
Units=單位
UnitsAndFlowProperties=單位和流動特性
Unknown=未知的
Unmark=取消標記
Up=無條件進位
UpToDate=更新-沒有變化
Update=更新
UpdateDatabase=資料庫更新
UpdateDatabaseQuestion=選擇的資料庫需要更新. 請問需要開始更新嗎?
UpdateMajorVersion=主要版本更新
UpdateMinorVersion=次要版本更新
UpdateReferenceCurrency=參考貨幣更新
UpdatingProductSystem=生產系統更新
UpstreamInclDirect=上傳包括.直接
UpstreamTotal=上傳總數
Usage=用法
UsageOf=用法
UseBrowserFeatures=使用瀏覽器功能
UseMaximumScoreForZeroValues=零值時使用最高評分
UsedInProcesses=用於工序
User=使用者
Validate=驗證
ValidatingDatabase=驗證資料庫
Value=值
Variant=選項
VariantDescriptionTable=生產系統說明表格
Variants=比對生產系統
Version=版本
VersionNewer=較新版本
VeryHighRisk=較高風險
VeryLowRisk=較低風險
Warning=警告
Warnings=警告
Waste=廢物
Website=網站
WeightedAverage=加權平均
WeightedSquaredAverage=加權方均
Weighting=加權
WeightingFactor=加權因素
Welcome=歡迎
Window=視窗(&W)
With=與
WithPassword=使用密碼
Year=年
Yes=是
ZipCode=郵遞區號
AboutOpenLCA=About openLCA
Active=Active
AddNewRepository=Add new repository
AddStickyNote=Add sticky note
ApplyFormat=Apply formatting
ApplyingDatabaseUpdates=Applying database updates
AreYouSureYouWantToCheckout=Are you sure you want to checkout the selected commit? This action will override your current database state and cannot be undone.
ArithmeticMean=Arithmetic mean
Authentication=Authentication
AutoLinkProcesses=Auto-link processes
AvoidedWaste=Avoided waste
BackupDatabase=Backup database
Both=Both
BrowseLocalFiles=Browse local files...
BuildFlowSupplyChain=Build flow supply chain
CannotRemoveSupplyChain=Cannot remove supply chain
CheckLinkingProperties=Check linking properties
Clear=Clear
CloseAll=Close all
Comments=Comments
CommitAndPush=Commit and Push
CommitError=An error occurred while receiving commit data
CompareWith=Compare with
Compress=Compress
CompressDatabase=Compress database
CompressingDatabase=Compressing database...
ConfigureRepositories=Configure repositories
ConnectionWithAnonymousAccess=Connection with anonymous access.
CopyMetaDataFromReferenceProcess=Copy meta data from reference process
CouldNotConnect=Could not connect, please check your internet connection and the provided url
CreateANewFlowForTheProcess=Create a new flow for the process (as quantitative reference)
CreateAWasteTreatmentProcess=Create a waste treatment process
DaysAgo=day(s) ago
DaysFromNow=day(s) from now
DeleteLocalDataset=Delete local dataset
Disabled=Disabled
Disconnect=Disconnect
DontShowSmallerThen=Don\u2018t show <
East=East
EditMode=Edit mode
EditStickyNote=Edit sticky note
EmailOrUsername=Username or email
EnableCollaboration=Enable collaboration
EnableComments=Enable comments
EnterYourAuthenticatorToken=Enter your authenticator token
EstimatedTimeRemaining=Estimated time remaining\:
EvaluateAllFormulas=Evaluate all formulas
ExchangesAreUsedOrNotDisconnected=One or more of the selected exchanges are already used in the product system or are not fully disconnected in this product system and therefore cannot be deleted.
Exit=Exit
Expired=Expired
ExpiryDate=Expiry date
Focus=Focus
Function=Function
GeneralDatabaseProperties=General database properties
Generator=Generator
HasInventoryResult=Has inventory result
HideExecutedUpdates=Hide executed updates
IgnoreDefaultProviders=Ignore default providers
ImpactMethod=Impact method
ImpactResults=Impact results
ImportRemoteDataset=Import remote dataset
IndexingDatasets=Indexing datasets
InputResults=Inventory results (resources)
IsBaseline=Is baseline
IsDefaultProvider=Is default provider
IsDisabled=Is disabled
IsProtected=Is protected
IsWithCosts=Is with costs
IsWithRegionalization=Is with regionalization
KeepDatasetDeleted=Keep dataset deleted
KeepLocalDataset=Keep local dataset
LCIAChecks=LCIA Checks
Library=Library
LicenseCorrupted=The library is corrupted (some files have been modified or deleted)
LicenseExpired=The library license is expired.
LicenseInformation=License information
LicenseNotYetValid=The library license is not yet valid.
LicenseUntrusted=The library license is not issued by a trusted certificate authority.
LicenseValid=The library license is valid.
LicenseWrongPassword=The provided password is wrong.
LicenseWrongUser=The provided user is wrong.
LinkingProperties=Linking properties
LoadingRepositoryList=Loading repository list
Manufacturer=Manufacturer
MapCanNotBeDisplayed=Map can not be displayed, do you have an active internet connection?
Merge=Merge
Minimap=Minimap
Modules=Modules
MoreThanXProcesses=More than 2000 processes will be displayed, this will take a while. Continue anyway?
NoLicenseDetected=No license detected.
NoOpportunity=No opportunity
NoRegionalizedInformation_Message=No regionalized information available for this system
NormalizationValue=Normalization value
North=North
OnlyLinkDefaultProviders=Only link default providers
OpenFlow=Open flow
OpenProvider=Open provider
OpenUpdateManager=Open Update Manager
Organisation=Organisation
OutputResults=Inventory results (emissions)
OverwriteLocalChanges=Overwrite local changes
OverwriteRemoteChanges=Overwrite remote changes
Owner=Owner
ParameterScope=Parameter scope
ParameterSets=Parameter sets
Pcr=PCR
PleaseEnterYourAuthenticatorTokenToProceed=Please enter your authenticator token to proceed
PleaseEnterYourCredentialsLibrary=Please enter your credentials to open the library.
PleaseSelectElements=Please select the elements, that you want to import. Required references will be loaded as well, if not selected.
PleaseSelectProperties=Please select the properties for the data quality assessment
PleaseSpecifyCompleteUrl=Please specify the complete url of the repository you want to import from. If the repository is not publicly accessible you need to enter your credentials to connect.
PreferDefaultProviders=Prefer default providers
PreferredProcessType=Preferred process type
ProcessesWithoutProviders=Processes without providers
ProductFlowSupplyReference=A product flow supplies the reference of the product system
ProgramOperator=Program operator
Provider=Provider
ProviderLinking=Provider linking
Pull=Pull
Push=Push
RebuildIndex=Rebuild index
RebuildingIndex=Rebuilding index
RemoveFlowSupplyChain=Remove flow supply chain
ReplaceIn=Replace in
Repository=Repository
RepositoryImport=Repository import
RepositoryPath=Repository path
RestoreDatabase=Restore database
Restriction=Restriction
RoutingEnabled=Routing enabled
SaveAll=Save all
SaveAsLCIResult=Save as LCI result
ScanningRepository=Scanning repository
SearchInCurrencies=Search in currencies
SearchInLCIACategories=Search in impact categories
SearchProviders=Search providers
SearchRecipients=Search recipients
SelectDataSets=Select data sets
SelectRepository=Select repository
SetAsQuantitativeReference=Set as quantitative reference
ShowComments=Show comments
ShowElementaryFlows=Show elementary flows
ShowExecutedUpdates=Show executed updates
SizeAfterCompression=Size after compression
SizeBeforeCompression=Size before compression
SomeElementsAreNotSaved=Some elements referenced by the product system are not saved yet. The calculation will not take these into account. Do you want to save them now?
South=South
StartIPCInfo=Click on the "run" button to start the IPC server.
StartIPCServer=Start an IPC Server
Status=Status
StopIPCInfo=The IPC server is running. Click on the `stop` button or close this dialog to stop it.
StoreInventoryResult=Store inventory result
ThisWillCompressTheDatabase=This will compress the database and free up unsused space. For bigger databases this might take a while.
ToggleEditMode=Toggle edit mode
ToggleMinimap=Toggle minimap
ToggleShowElementaryFlows=Toggle show elementary flows
TypeOfRestriction=Type of restriction
UnsavedChanges=Unsaved changes
UpdateWasAlreadyAddedOrExecuted=Update was already added or executed
UpgradingRepositoryIndex=Upgrading repository index
Urn=URN
UsageType=Usage type
Valid=Valid
Vendor=Vendor
Verifier=Verifier
WaitingForServerToIndexDatasets=Waiting for server to index datasets
WasteFlowSupplyReference=A waste flow supplies the reference of the product system
WeightedArithmeticMean=Weighted arithmetic mean
West=West
