ActorEditor=參與者編輯
Actors=參與者
Configuration=設定
DataProvider=資料提供者
EcoSpold=EcoSpold 1
ElementaryFlows=元素流程
EmptyCategories=空類別
FlowEditor=流程編輯
FlowProperties=流程特性
FlowPropertyEditor=流程特性編輯
Flows=流程
GlobalParameters=全域參數
ILCDNetworkExport=從 ILCD 網路匯出
ILCDNetworkImport=從 ILCD 網路匯入
ImpactMethodEditor=影響評估方法編輯
ImpactMethods=影響評估方法
ImportExport=匯出/匯入
LCIAMethods=LCIA方法
Locations=位置
Logging=紀錄
Navigation=導覽
NumberFormat=數字格式
Perspective=透視
ProcessEditor=工序編輯
Processes=工序
ProductFlows=生產流程
ProductSystemEditor=生產系統編輯
ProductSystems=生產系統
ProjectEditor=專案編輯
ReportViewer=報告閱覽者
SourceEditor=來源編輯
Sources=來源
UnitGroupEditor=單位群組編輯
UnitGroups=單位群組
Updates=更新
Usage=用法
WasteFlows=廢物流程
Welcome=歡迎
Comments=Comments
ImportEntireDatabase=Import entire database
ImportEntireDatabase_Info=Import an entire database into the active database.
SearchResults=Search results